0,0,0,0,0,1,0,-1,-1,1,2,2,1,-2,-3,-2,-1,2,4,3,3,5,5,5,3,0,-4,-6,-6,-6,-5,-3,
6,6,6,6,6,6,5,4,5,6,6,7,6,4,1,1,2,5,7,6,6,7,7,7,7,4,1,0,-1,-1,-2,0,
10,9,9,9,10,10,9,9,11,11,10,10,10,8,6,5,6,8,9,8,8,10,10,10,10,9,6,4,3,1,0,1,
13,12,11,12,13,13,12,13,15,14,12,11,11,11,10,11,12,14,14,12,12,13,13,13,13,12,9,7,5,3,1,2,
16,15,14,14,15,15,15,16,17,16,14,13,13,13,14,16,17,19,19,17,15,15,15,14,14,12,11,9,7,5,4,6,
18,17,15,15,16,17,17,17,17,16,15,15,16,16,18,20,21,21,21,19,16,16,16,17,15,13,11,10,10,10,9,10,
19,17,16,16,17,18,17,17,17,18,18,18,18,19,20,22,22,22,22,19,16,15,16,17,17,15,12,12,14,15,14,15,
20,18,17,18,18,18,17,17,19,20,20,19,18,19,22,23,23,23,22,20,16,14,15,16,17,16,14,13,15,18,19,21,
22,20,19,19,19,17,16,17,19,21,21,19,20,21,23,25,24,22,20,19,16,15,15,16,17,17,16,15,17,20,23,26,
24,22,20,20,19,17,18,19,21,21,21,21,21,23,24,23,23,21,19,19,18,16,17,17,17,18,18,19,21,24,25,27,
25,22,20,19,18,18,18,20,21,22,22,21,21,22,22,21,20,20,20,20,19,17,18,19,19,20,21,22,25,27,27,27,
24,23,20,18,17,16,18,19,20,20,22,21,19,20,19,19,19,21,22,22,20,18,19,20,20,21,23,24,26,29,27,27,
23,23,21,18,16,15,17,18,19,19,21,20,19,18,17,18,20,22,23,22,21,19,20,21,21,22,23,24,26,29,28,28,
23,23,21,18,16,16,18,19,20,21,21,21,19,18,17,18,21,23,23,22,22,21,22,21,20,21,22,23,26,29,29,30,
22,21,20,18,17,16,17,19,21,21,20,18,17,16,15,16,20,23,24,24,23,23,22,20,20,21,23,23,26,30,31,31,
23,21,19,18,19,18,18,20,21,19,16,14,14,14,14,16,20,23,24,24,24,23,20,18,19,21,23,24,27,31,32,31,
25,23,20,19,20,19,19,21,20,17,14,13,14,15,15,18,21,22,22,22,22,22,20,18,18,21,23,25,27,31,32,30,
28,25,22,21,20,19,19,19,18,16,14,12,13,15,18,20,22,23,22,21,21,21,20,19,20,22,24,25,27,29,30,29,
28,25,23,21,20,18,17,17,15,15,14,12,13,16,19,20,21,22,22,22,20,20,20,22,23,24,24,25,26,26,26,26,
27,24,21,19,17,17,17,16,14,13,13,13,13,16,18,19,20,21,22,21,20,20,20,22,22,22,22,24,25,24,22,21,
25,23,20,18,16,16,15,14,12,12,12,12,13,16,18,18,18,19,19,19,19,19,19,19,20,20,21,23,23,20,18,17,
24,22,21,18,16,14,12,11,10,10,11,10,11,14,17,17,16,16,17,18,18,17,17,17,17,18,19,19,18,15,14,15,
23,22,20,18,16,13,11,9,7,7,8,9,10,13,16,15,14,14,16,17,18,17,16,16,14,14,15,15,13,11,10,12,
23,22,20,17,15,13,10,7,5,4,6,8,10,12,14,12,12,12,14,15,16,17,17,14,11,10,11,12,10,8,8,10,
21,21,19,18,16,13,8,5,2,3,4,7,9,10,10,10,11,12,12,13,15,17,15,12,9,10,11,10,8,7,9,11,
19,19,18,17,16,13,8,5,2,2,4,6,7,8,9,9,11,13,13,13,14,15,13,10,8,9,10,9,7,6,9,11,
16,17,17,16,15,12,8,5,2,2,4,5,6,7,8,9,11,13,15,15,15,13,11,8,7,8,9,8,6,5,8,10,
15,16,16,15,12,9,6,5,3,2,3,4,5,7,8,8,10,12,14,15,14,11,8,7,6,5,5,6,4,4,6,9,
13,14,13,11,9,6,5,6,4,3,3,3,4,6,8,9,11,11,11,11,11,8,6,5,4,2,2,2,1,0,3,6,
13,13,10,7,6,5,6,7,5,4,4,3,3,6,8,10,12,11,7,6,6,4,2,1,1,0,-1,-1,-3,-3,0,3,
15,13,8,6,5,5,6,7,6,5,5,3,3,5,8,10,12,10,5,2,0,-1,-4,-4,-2,-1,-2,-2,-3,-3,-1,2,
16,13,10,8,7,5,5,7,6,5,5,4,4,7,8,9,10,8,4,1,-2,-4,-6,-6,-4,-4,-4,-3,-3,-2,0,4,
